33331100000112222
33331100000110000
13331000000000000
13330000011011111
11333111111011331
33330000133333331
33300000222233333
33111000000333333
33110000033333333
33110011000000031
33100111100022313
13300000000022232
11330000000022333
11133001110022030
21113001010033333