00002000002000000
00102000001010010
00100000011012210
00101000000000000
33001000000000000
33301000020000031
33300033330020031
00111133330000031
00000000002000031
21322301010032200
01322001010032200
01000001110033300
01000000000000001
01322001113300001
01322301013300011