00000000000000000
01010101010101010
01010101010101010
01010101210101010
01010101010101010
01010100000101010
00000001010000000
00011100000111000
20011101010111002
00000001110000000
01010101010101010
01010101010101010
01010100000101010
01010101110101010
00000001010000000