33331100000112222
33331100000110000
13331000000000000
13330000011011111
11333111111011331
43330000133333331
43300000222234433
43111000000334433
43110000033333333
33110011000000031
33100111100022313
13300000000022232
11330000000022333
11133001110022030
21113001010033333